NO ./Assets/textures/brushed-metal-north.xpm
SO ./Assets/textures/brushed-metal-south.xpm
WE ./Assets/textures/brushed-metal-west.xpm
EA ./Assets/textures/brushed-metal-east.xpm

F 0,0,0
C 105,104,101

                   11111111111111
        1111111111110000000000001
        1000000000110000001000001
        1011000001110000010100001
        10010000000000N0001000001
111111111011000001110000000000001
100000000011000001110111111111111
11110111111111011100000010001
11110111111111011101010010001
11000000110101011100000010001
11111111111111111111111111111

11111111111111111111111111111
10000000000000000000000000001
10000000000000000000000000001
10000000000000001101010010001
11000001110101011111011110001111
11110111 1110101 101111010001
11111111 1111111 111111111111